ID,R_Score,F_Score,M_Score,RFM_Score,RFM_Label
5524,3,5,5,13,Loyal
2174,4,1,1,6,New Customers
4141,4,4,4,12,Champions
6182,4,2,1,7,New Customers
5324,1,4,3,8,Regulars
7446,5,4,4,13,Champions
965,4,4,3,11,Loyal
6177,4,2,2,8,New Customers
4855,5,1,1,7,New Customers
5899,2,1,1,4,At Risk
1994,5,1,1,7,New Customers
387,3,1,2,6,Regulars
2125,1,3,4,8,Regulars
8180,3,3,3,9,Regulars
2569,4,1,1,6,New Customers
2114,4,5,5,14,Champions
9736,3,2,2,7,Regulars
4939,4,3,3,10,Loyal
6565,1,5,5,11,Loyal
2278,1,2,2,5,At Risk
9360,3,3,3,9,Regulars
5376,3,5,4,12,Loyal
1993,2,3,4,9,Regulars
4047,5,4,3,12,Champions
1409,2,4,3,9,Regulars
7892,1,2,2,5,At Risk
2404,5,3,3,11,Loyal
5255,5,3,3,11,Loyal
9422,4,2,2,8,New Customers
1966,1,5,5,11,Loyal
6864,4,2,1,7,New Customers
3033,3,2,3,8,Regulars
5710,4,2,2,8,New Customers
7373,5,3,3,11,Loyal
8755,5,4,5,14,Champions
10738,3,1,2,6,Regulars
4339,4,5,4,13,Champions
10755,2,2,2,6,At Risk
8595,1,1,2,4,At Risk
8601,5,4,5,14,Champions
503,1,1,1,3,At Risk
8430,5,1,1,7,New Customers
7281,1,2,2,5,At Risk
2139,5,2,1,8,New Customers
1371,2,3,4,9,Regulars
9909,4,2,2,8,New Customers
7286,1,1,1,3,At Risk
7244,1,2,2,5,At Risk
6566,4,5,5,14,Champions
8614,4,3,3,10,Loyal
4114,5,5,5,15,Champions
1331,3,1,2,6,Regulars
2225,3,4,5,12,Loyal
9381,3,5,3,11,Loyal
6260,3,5,5,13,Loyal
10383,4,4,4,12,Champions
7437,4,1,1,6,New Customers
8557,3,1,1,5,Regulars
8375,2,4,3,9,Regulars
6853,5,4,5,14,Champions
3076,5,4,3,12,Champions
1012,4,5,4,13,Champions
6518,5,4,3,12,Champions
4137,4,3,4,11,Loyal
8082,2,1,1,4,At Risk
1386,5,1,1,7,New Customers
9369,5,5,5,15,Champions
4477,5,4,4,13,Champions
1357,1,4,5,10,Loyal
1402,5,4,5,14,Champions
10629,4,2,2,8,New Customers
6312,4,5,4,13,Champions
8132,1,5,4,10,Loyal
1050,3,2,2,7,Regulars
5846,2,1,1,4,At Risk
1859,4,4,5,13,Champions
7503,3,4,5,12,Loyal
10401,5,1,1,7,New Customers
1618,5,4,4,13,Champions
3332,1,3,2,6,At Risk
2261,5,1,1,7,New Customers
5346,1,2,2,5,At Risk
4119,3,2,3,8,Regulars
535,5,5,4,14,Champions
5268,1,1,2,4,At Risk
273,3,3,2,8,Regulars
4452,5,3,3,11,Loyal
8504,2,4,5,11,Loyal
771,2,2,3,7,Regulars
8996,5,5,3,13,Champions
9235,3,1,1,5,Regulars
5798,1,3,4,8,Regulars
11178,2,1,1,4,At Risk
2230,1,2,1,4,At Risk
7516,4,1,1,6,New Customers
7247,2,4,3,9,Regulars
11100,4,1,2,7,New Customers
4646,3,5,4,12,Loyal
3037,4,3,3,10,Loyal
1473,5,1,2,8,New Customers
1016,3,1,1,5,Regulars
4518,3,5,5,13,Loyal
9370,2,3,4,9,Regulars
8908,4,4,4,12,Champions
8373,1,1,1,3,At Risk
7533,5,3,2,10,Loyal
2683,3,5,4,12,Loyal
3629,5,2,2,9,New Customers
10991,5,3,4,12,Loyal
5077,3,5,4,12,Loyal
7431,3,3,5,11,Loyal
3267,4,4,3,11,Loyal
999,1,5,4,10,Loyal
9215,5,4,3,12,Champions
2286,4,2,2,8,New Customers
1592,4,3,5,12,Loyal
367,2,4,3,9,Regulars
5234,1,1,2,4,At Risk
9862,4,1,1,6,New Customers
9805,2,4,4,10,Loyal
6205,5,2,2,9,New Customers
8442,2,1,1,4,At Risk
7386,1,1,1,3,At Risk
7215,2,5,4,11,Loyal
1491,1,3,3,7,Regulars
11071,4,3,5,12,Loyal
3381,3,2,2,7,Regulars
8268,4,3,3,10,Loyal
11051,2,5,4,11,Loyal
8026,5,4,3,12,Champions
433,3,5,4,12,Loyal
9597,5,4,4,13,Champions
1295,1,4,4,9,Regulars
5290,3,3,3,9,Regulars
1685,4,5,5,14,Champions
5342,4,1,1,6,New Customers
9579,2,2,2,6,At Risk
7660,4,1,1,6,New Customers
1461,2,1,1,4,At Risk
821,3,4,5,12,Loyal
11084,5,3,4,12,Loyal
8690,2,5,5,12,Loyal
2937,3,5,4,12,Loyal
9701,5,3,3,11,Loyal
9949,4,3,4,11,Loyal
10837,3,1,2,6,Regulars
3120,3,1,1,5,Regulars
5885,1,3,3,7,Regulars
4050,2,2,2,6,At Risk
3830,3,3,3,9,Regulars
7987,1,4,3,8,Regulars
7798,4,3,3,10,Loyal
92,5,2,2,9,New Customers
7055,3,5,4,12,Loyal
10240,5,4,5,14,Champions
3025,5,3,3,11,Loyal
9283,3,1,1,5,Regulars
9970,5,2,2,9,New Customers
2730,2,4,5,11,Loyal
2795,5,1,1,7,New Customers
9260,4,5,5,14,Champions
8182,1,2,2,5,At Risk
10095,5,4,5,14,Champions
8475,1,5,4,10,Loyal
4370,1,2,2,5,At Risk
10573,4,4,3,11,Loyal
3712,2,3,3,8,Regulars
6637,3,3,4,10,Loyal
3152,1,2,2,5,At Risk
5610,3,1,1,5,Regulars
6460,2,1,2,5,At Risk
1349,5,2,2,9,New Customers
1880,5,2,2,9,New Customers
641,2,1,2,5,At Risk
8717,3,5,5,13,Loyal
10314,2,5,5,12,Loyal
10854,1,1,1,3,At Risk
10492,1,1,1,3,At Risk
6935,3,5,4,12,Loyal
7698,1,2,2,5,At Risk
3559,2,2,2,6,At Risk
10562,4,5,4,13,Champions
10796,5,1,2,8,New Customers
2563,1,1,1,3,At Risk
3518,3,1,1,5,Regulars
5823,2,1,1,4,At Risk
3934,4,4,3,11,Loyal
6982,5,5,5,15,Champions
6431,5,1,2,8,New Customers
9733,3,1,2,6,Regulars
5602,1,5,5,11,Loyal
1324,1,2,2,5,At Risk
326,4,3,3,10,Loyal
7224,4,1,1,6,New Customers
6999,1,5,4,10,Loyal
9938,1,3,5,9,Regulars
6422,4,3,5,12,Loyal
3182,1,3,3,7,Regulars
7300,3,4,3,10,Loyal
10424,2,4,5,11,Loyal
8727,2,5,4,11,Loyal
2798,3,5,5,13,Loyal
1030,2,1,1,4,At Risk
624,5,1,1,7,New Customers
5176,1,1,1,3,At Risk
5552,3,3,3,9,Regulars
868,1,1,2,4,At Risk
380,5,5,5,15,Champions
2677,5,3,3,11,Loyal
6521,5,4,4,13,Champions
6927,2,4,3,9,Regulars
2877,4,5,3,12,Champions
0,2,3,5,10,Loyal
1584,2,4,3,9,Regulars
7264,5,1,1,7,New Customers
6274,1,5,5,11,Loyal
1377,4,3,3,10,Loyal
454,3,5,4,12,Loyal
1755,1,1,2,4,At Risk
2075,3,3,4,10,Loyal
4785,5,4,4,13,Champions
9076,3,3,2,8,Regulars
7079,4,5,5,14,Champions
4653,3,3,2,8,Regulars
7375,1,3,3,7,Regulars
709,4,4,4,12,Champions
460,2,3,5,10,Loyal
3726,2,1,1,4,At Risk
6798,4,5,3,12,Champions
5341,5,3,5,13,Loyal
1606,2,1,1,4,At Risk
9617,4,1,1,6,New Customers
3233,1,5,4,10,Loyal
89,3,2,2,7,Regulars
2936,3,1,1,5,Regulars
9449,4,4,3,11,Loyal
7297,3,2,2,7,Regulars
313,1,4,5,10,Loyal
9940,1,3,4,8,Regulars
10735,2,1,1,4,At Risk
9529,5,4,5,14,Champions
6439,4,5,4,13,Champions
7411,4,1,1,6,New Customers
2176,3,3,5,11,Loyal
9265,2,4,5,11,Loyal
8867,1,4,5,10,Loyal
8932,3,5,5,13,Loyal
10236,3,1,2,6,Regulars
6340,3,1,1,5,Regulars
10089,5,5,4,14,Champions
2227,1,2,3,6,At Risk
10992,2,5,4,11,Loyal
5304,4,1,1,6,New Customers
309,3,4,4,11,Loyal
3406,1,3,3,7,Regulars
2661,1,2,1,4,At Risk
3153,4,1,1,6,New Customers
10264,2,1,1,4,At Risk
1184,3,5,4,12,Loyal
4200,1,3,3,7,Regulars
9396,4,1,1,6,New Customers
2387,5,3,3,11,Loyal
6690,4,2,2,8,New Customers
1225,3,4,5,12,Loyal
9703,2,2,2,6,At Risk
291,5,3,4,12,Loyal
4557,5,2,2,9,New Customers
2379,4,3,5,12,Loyal
5726,5,2,2,9,New Customers
3066,5,3,3,11,Loyal
6336,3,2,1,6,Regulars
10967,4,2,2,8,New Customers
2304,1,5,4,10,Loyal
3445,3,5,4,12,Loyal
7828,4,3,4,11,Loyal
3762,4,3,4,11,Loyal
4391,2,4,4,10,Loyal
4669,3,2,2,7,Regulars
10144,1,3,3,7,Regulars
8652,4,3,3,10,Loyal
1672,2,3,3,8,Regulars
8962,5,1,1,7,New Customers
9974,2,1,2,5,At Risk
10983,5,5,4,14,Champions
8148,1,5,4,10,Loyal
10102,5,4,5,14,Champions
4697,2,3,3,8,Regulars
9262,5,1,1,7,New Customers
7254,2,2,2,6,At Risk
4543,4,4,5,13,Champions
4927,2,2,2,6,At Risk
10451,5,1,1,7,New Customers
2926,2,5,5,12,Loyal
2874,4,1,1,6,New Customers
9738,3,1,2,6,Regulars
7119,3,3,4,10,Loyal
3924,4,5,4,13,Champions
5827,3,2,2,7,Regulars
5596,3,4,4,11,Loyal
10812,1,1,2,4,At Risk
1717,3,3,3,9,Regulars
9491,2,2,2,6,At Risk
9274,3,5,5,13,Loyal
6609,2,1,2,5,At Risk
6963,1,4,4,9,Regulars
4440,1,4,3,8,Regulars
1379,5,2,3,10,New Customers
10032,1,2,1,4,At Risk
2826,4,1,1,6,New Customers
2437,2,5,5,12,Loyal
6320,3,5,5,13,Loyal
3050,5,3,3,11,Loyal
231,1,1,1,3,At Risk
2392,3,2,2,7,Regulars
9478,4,3,3,10,Loyal
113,4,1,1,6,New Customers
2863,2,4,4,10,Loyal
1802,4,4,4,12,Champions
520,1,1,1,3,At Risk
8275,5,1,1,7,New Customers
9750,3,5,5,13,Loyal
2607,2,5,4,11,Loyal
7214,3,4,5,12,Loyal
5835,4,2,2,8,New Customers
3896,5,1,1,7,New Customers
10350,4,1,1,6,New Customers
7786,4,3,2,9,Regulars
2861,2,1,1,4,At Risk
663,3,1,2,6,Regulars
10675,1,4,4,9,Regulars
2521,5,1,2,8,New Customers
9592,3,1,1,5,Regulars
10151,4,4,4,12,Champions
7381,5,4,5,14,Champions
4099,5,1,2,8,New Customers
9560,5,4,5,14,Champions
10172,1,4,5,10,Loyal
11191,5,2,2,9,New Customers
9707,2,4,5,11,Loyal
6245,2,4,3,9,Regulars
8234,5,1,1,7,New Customers
1411,3,3,4,10,Loyal
8553,2,1,1,4,At Risk
1826,5,3,5,13,Loyal
8842,4,2,1,7,New Customers
11030,1,1,1,3,At Risk
2579,1,5,4,10,Loyal
175,1,4,5,10,Loyal
9185,4,4,4,12,Champions
11056,5,4,5,14,Champions
9365,3,5,5,13,Loyal
6201,3,1,1,5,Regulars
2061,2,1,2,5,At Risk
6184,5,3,5,13,Loyal
4107,3,3,3,9,Regulars
7274,1,4,5,10,Loyal
9336,4,4,4,12,Champions
2958,3,2,2,7,Regulars
933,4,1,1,6,New Customers
5837,2,4,3,9,Regulars
10704,2,4,4,10,Loyal
5125,2,5,5,12,Loyal
4432,1,1,1,3,At Risk
5955,4,3,5,12,Loyal
2928,2,3,4,9,Regulars
5680,2,1,1,4,At Risk
10313,2,3,3,8,Regulars
2557,3,1,1,5,Regulars
1245,3,5,5,13,Loyal
1519,5,2,2,9,New Customers
10703,1,2,2,5,At Risk
1726,4,1,2,7,New Customers
4459,5,1,1,7,New Customers
1729,5,4,5,14,Champions
1517,1,1,1,3,At Risk
2098,4,1,1,6,New Customers
9543,2,1,1,4,At Risk
6878,5,3,3,11,Loyal
3310,1,3,3,7,Regulars
2724,4,1,1,6,New Customers
948,4,2,1,7,New Customers
6720,5,3,3,11,Loyal
6202,2,5,4,11,Loyal
2066,3,1,2,6,Regulars
9799,3,4,5,12,Loyal
8318,5,4,5,14,Champions
5642,5,3,3,11,Loyal
2669,2,3,4,9,Regulars
455,1,2,3,6,At Risk
7683,1,5,4,10,Loyal
3428,3,5,5,13,Loyal
7414,5,3,2,10,Loyal
6354,3,1,1,5,Regulars
798,2,1,1,4,At Risk
8213,2,2,2,6,At Risk
2488,1,2,2,5,At Risk
9999,5,5,4,14,Champions
7617,1,3,2,6,At Risk
615,4,2,3,9,New Customers
2552,5,5,3,13,Champions
194,3,1,1,5,Regulars
3645,5,2,2,9,New Customers
8890,5,3,3,11,Loyal
5049,5,1,1,7,New Customers
9973,4,4,3,11,Loyal
7301,2,2,2,6,At Risk
10882,3,3,4,10,Loyal
7030,5,5,5,15,Champions
7422,1,3,3,7,Regulars
3523,1,4,4,9,Regulars
6504,4,2,2,8,New Customers
5067,5,4,5,14,Champions
4216,4,5,5,14,Champions
8581,5,5,4,14,Champions
5929,5,1,1,7,New Customers
3129,4,1,1,6,New Customers
6528,2,1,1,4,At Risk
1361,4,3,5,12,Loyal
7284,5,1,1,7,New Customers
1340,3,5,5,13,Loyal
8746,4,4,5,13,Champions
5987,3,1,1,5,Regulars
3767,5,5,4,14,Champions
3725,5,3,5,13,Loyal
4324,3,4,4,11,Loyal
238,2,5,4,11,Loyal
6694,4,5,4,13,Champions
498,4,1,2,7,New Customers
9347,3,1,1,5,Regulars
9699,5,5,4,14,Champions
10664,5,3,3,11,Loyal
5455,1,2,2,5,At Risk
456,1,1,1,3,At Risk
5012,3,1,1,5,Regulars
7495,2,2,2,6,At Risk
5029,5,1,1,7,New Customers
10642,5,1,1,7,New Customers
2106,1,1,1,3,At Risk
10364,2,1,1,4,At Risk
5954,1,2,3,6,At Risk
1137,1,3,5,9,Regulars
2541,5,1,1,7,New Customers
1142,1,3,3,7,Regulars
2276,2,5,4,11,Loyal
2807,4,5,4,13,Champions
6471,5,1,2,8,New Customers
6131,1,3,3,7,Regulars
6233,4,5,4,13,Champions
4148,1,4,3,8,Regulars
4947,3,5,5,13,Loyal
3225,2,3,3,8,Regulars
7540,3,3,3,9,Regulars
10648,2,4,5,11,Loyal
1992,5,3,4,12,Loyal
7851,2,4,4,10,Loyal
8594,4,2,2,8,New Customers
7059,3,4,5,12,Loyal
2815,3,2,2,7,Regulars
2416,1,4,5,10,Loyal
7999,5,3,5,13,Loyal
9213,5,1,1,7,New Customers
9697,1,4,3,8,Regulars
3916,1,5,4,10,Loyal
2021,3,5,5,13,Loyal
1581,5,1,1,7,New Customers
564,1,5,4,10,Loyal
6619,1,1,1,3,At Risk
9081,3,1,1,5,Regulars
178,3,5,4,12,Loyal
916,2,1,1,4,At Risk
5512,5,3,3,11,Loyal
8970,1,4,3,8,Regulars
10581,3,4,3,10,Loyal
5300,2,1,2,5,At Risk
5154,3,1,1,5,Regulars
8346,4,3,3,10,Loyal
1676,4,3,3,10,Loyal
9286,1,4,4,9,Regulars
2426,4,5,4,13,Champions
5172,5,3,4,12,Loyal
5562,1,4,4,9,Regulars
3436,4,1,1,6,New Customers
3921,1,2,3,6,At Risk
3403,5,4,5,14,Champions
22,1,3,3,7,Regulars
10965,2,4,5,11,Loyal
9426,2,3,4,9,Regulars
3136,1,4,4,9,Regulars
8737,4,1,1,6,New Customers
11088,1,4,5,10,Loyal
716,2,5,4,11,Loyal
9135,1,1,2,4,At Risk
10623,5,1,1,7,New Customers
8151,5,2,3,10,New Customers
5140,2,4,5,11,Loyal
10160,3,1,1,5,Regulars
4945,4,5,5,14,Champions
10584,2,5,4,11,Loyal
6071,2,4,4,10,Loyal
3386,2,2,2,6,At Risk
8939,3,5,4,12,Loyal
9925,1,3,3,7,Regulars
4320,5,5,4,14,Champions
5389,1,3,3,7,Regulars
6036,2,4,5,11,Loyal
182,2,3,3,8,Regulars
203,3,4,5,12,Loyal
11025,5,2,2,9,New Customers
10203,2,1,1,4,At Risk
4607,4,3,4,11,Loyal
3696,2,1,1,4,At Risk
2532,1,3,5,9,Regulars
9214,3,3,3,9,Regulars
4943,2,3,5,10,Loyal
35,4,2,3,9,New Customers
2258,2,1,1,4,At Risk
4322,4,4,5,13,Champions
713,2,3,3,8,Regulars
4702,4,3,5,12,Loyal
3281,2,4,3,9,Regulars
702,1,4,3,8,Regulars
2004,2,3,5,10,Loyal
4769,3,5,3,11,Loyal
4437,2,3,3,8,Regulars
8724,3,1,1,5,Regulars
10741,2,3,3,8,Regulars
1991,5,1,2,8,New Customers
6931,5,3,4,12,Loyal
11096,3,3,3,9,Regulars
304,2,2,2,6,At Risk
3665,3,2,1,6,Regulars
10591,4,2,3,9,New Customers
5036,4,3,3,10,Loyal
5547,5,4,5,14,Champions
7822,3,4,4,11,Loyal
8541,1,2,1,4,At Risk
10955,2,3,5,10,Loyal
4368,2,2,2,6,At Risk
9671,3,2,2,7,Regulars
2256,4,1,1,6,New Customers
4279,1,1,1,3,At Risk
5371,5,2,2,9,New Customers
9240,2,4,3,9,Regulars
9460,2,2,2,6,At Risk
9504,5,5,4,14,Champions
8692,3,3,3,9,Regulars
448,3,4,4,11,Loyal
8314,4,4,5,13,Champions
8420,4,2,2,8,New Customers
3174,2,4,5,11,Loyal
7685,5,2,2,9,New Customers
3179,2,4,5,11,Loyal
9780,5,5,4,14,Champions
10681,5,5,4,14,Champions
10232,5,3,3,11,Loyal
4184,3,3,3,9,Regulars
9120,1,4,4,9,Regulars
891,2,1,1,4,At Risk
10381,3,1,1,5,Regulars
3525,5,1,1,7,New Customers
6818,4,3,3,10,Loyal
3526,3,1,1,5,Regulars
8181,3,2,2,7,Regulars
1029,4,3,3,10,Loyal
7369,3,2,2,7,Regulars
2574,4,4,5,13,Champions
8159,5,2,2,9,New Customers
1160,3,2,1,6,Regulars
10242,4,2,2,8,New Customers
5253,1,3,3,7,Regulars
5966,2,3,3,8,Regulars
5314,2,4,3,9,Regulars
5081,3,1,1,5,Regulars
5123,3,2,2,7,Regulars
5756,2,2,1,5,At Risk
8036,5,2,2,9,New Customers
9058,2,4,5,11,Loyal
5057,2,4,3,9,Regulars
254,5,4,3,12,Champions
4179,1,1,1,3,At Risk
3710,3,2,2,7,Regulars
7627,4,4,5,13,Champions
4501,1,4,5,10,Loyal
6424,5,1,1,7,New Customers
3075,3,3,3,9,Regulars
4992,5,2,2,9,New Customers
5252,1,1,2,4,At Risk
7444,4,1,1,6,New Customers
6919,4,2,2,8,New Customers
3537,3,2,2,7,Regulars
10277,4,1,1,6,New Customers
2453,1,5,4,10,Loyal
7972,2,3,4,9,Regulars
895,2,4,3,9,Regulars
1177,2,2,2,6,At Risk
7141,5,3,3,11,Loyal
7232,1,2,2,5,At Risk
8477,2,1,1,4,At Risk
2457,4,1,1,6,New Customers
988,1,4,5,10,Loyal
7930,2,3,3,8,Regulars
6682,3,1,1,5,Regulars
6222,4,2,1,7,New Customers
10299,2,5,4,11,Loyal
3083,1,4,3,8,Regulars
8953,1,1,1,3,At Risk
1503,4,1,2,7,New Customers
8650,4,1,1,6,New Customers
10862,5,3,3,11,Loyal
2782,4,3,3,10,Loyal
6941,1,1,2,4,At Risk
10972,3,3,4,10,Loyal
10708,3,1,1,5,Regulars
6583,3,4,4,11,Loyal
3641,1,2,1,4,At Risk
10156,3,4,5,12,Loyal
4299,4,5,5,14,Champions
3469,1,2,2,5,At Risk
5063,2,3,3,8,Regulars
10727,3,5,5,13,Loyal
9624,3,3,4,10,Loyal
5156,5,5,4,14,Champions
4376,4,2,2,8,New Customers
8923,5,4,5,14,Champions
8461,5,1,1,7,New Customers
6945,2,5,5,12,Loyal
944,5,3,3,11,Loyal
1907,3,5,5,13,Loyal
701,3,4,5,12,Loyal
3856,2,5,4,11,Loyal
4149,3,4,5,12,Loyal
2131,4,5,5,14,Champions
2942,4,3,3,10,Loyal
1173,2,3,5,10,Loyal
4381,3,3,3,9,Regulars
4611,4,5,5,14,Champions
3376,5,2,3,10,New Customers
4679,3,5,4,12,Loyal
10928,4,3,3,10,Loyal
4248,4,4,5,13,Champions
6728,4,1,1,6,New Customers
6661,2,5,5,12,Loyal
4725,2,2,2,6,At Risk
3277,5,3,3,11,Loyal
5555,1,1,1,3,At Risk
2564,1,2,2,5,At Risk
946,1,2,3,6,At Risk
3867,4,5,4,13,Champions
6940,1,3,3,7,Regulars
55,1,4,3,8,Regulars
7093,2,1,1,4,At Risk
5084,1,5,4,10,Loyal
1777,4,1,2,7,New Customers
8162,1,1,1,3,At Risk
10826,2,1,2,5,At Risk
8754,4,1,1,6,New Customers
1987,4,2,2,8,New Customers
11007,3,1,1,5,Regulars
7426,2,3,3,8,Regulars
9153,1,5,4,10,Loyal
10379,1,4,3,8,Regulars
9204,4,3,4,11,Loyal
3197,4,4,4,12,Champions
2920,2,3,4,9,Regulars
6961,4,1,1,6,New Customers
4673,5,4,5,14,Champions
9937,2,3,3,8,Regulars
8779,5,3,2,10,Loyal
9596,5,4,4,13,Champions
2891,3,5,4,12,Loyal
4910,1,5,5,11,Loyal
75,4,3,3,10,Loyal
10120,1,3,3,7,Regulars
6327,1,3,4,8,Regulars
10142,1,4,4,9,Regulars
9826,1,4,5,10,Loyal
1501,4,5,4,13,Champions
10767,3,4,5,12,Loyal
7279,5,3,4,12,Loyal
7230,1,4,3,8,Regulars
143,2,3,4,9,Regulars
450,1,3,3,7,Regulars
9316,4,1,1,6,New Customers
6379,5,2,2,9,New Customers
9239,1,2,2,5,At Risk
8315,2,1,1,4,At Risk
2868,4,2,2,8,New Customers
10888,3,4,4,11,Loyal
1277,4,5,4,13,Champions
9977,1,4,4,9,Regulars
10196,4,4,3,11,Loyal
6384,4,4,5,13,Champions
8029,4,3,5,12,Loyal
968,4,3,2,9,Regulars
6988,1,4,5,10,Loyal
4472,4,1,2,7,New Customers
6991,1,4,4,9,Regulars
3336,1,3,4,8,Regulars
4301,5,1,2,8,New Customers
1940,4,1,1,6,New Customers
1272,3,5,4,12,Loyal
1388,5,2,2,9,New Customers
1044,3,4,3,10,Loyal
6969,2,3,3,8,Regulars
10479,2,2,5,9,Regulars
3619,5,3,4,12,Loyal
1715,3,2,1,6,Regulars
10159,2,5,5,12,Loyal
1463,5,1,1,7,New Customers
5114,5,3,4,12,Loyal
4990,1,4,4,9,Regulars
4329,3,1,1,5,Regulars
10936,2,3,5,10,Loyal
4692,5,3,2,10,Loyal
7212,1,1,2,4,At Risk
6086,2,5,5,12,Loyal
437,3,5,4,12,Loyal
11171,2,4,3,9,Regulars
11101,5,5,4,14,Champions
5329,4,1,1,6,New Customers
610,2,5,3,10,Loyal
9384,3,5,3,11,Loyal
5956,2,3,3,8,Regulars
10430,4,3,5,12,Loyal
7875,3,5,5,13,Loyal
7072,2,4,5,11,Loyal
6255,4,3,3,10,Loyal
6516,4,1,1,6,New Customers
5564,4,4,5,13,Champions
5682,5,5,4,14,Champions
7458,4,2,2,8,New Customers
5237,2,2,2,6,At Risk
7761,2,2,2,6,At Risk
5278,1,4,4,9,Regulars
3560,3,4,5,12,Loyal
7235,4,2,1,7,New Customers
10548,4,5,4,13,Champions
2281,4,1,1,6,New Customers
4073,5,5,5,15,Champions
6974,1,4,5,10,Loyal
7938,1,3,3,7,Regulars
7094,1,5,4,10,Loyal
3667,4,5,5,14,Champions
7723,3,4,5,12,Loyal
3870,4,5,4,13,Champions
4012,3,5,5,13,Loyal
5909,4,4,5,13,Champions
10470,5,2,2,9,New Customers
6488,1,2,2,5,At Risk
10270,5,2,2,9,New Customers
6887,4,4,3,11,Loyal
6406,5,4,5,14,Champions
7573,5,1,2,8,New Customers
4508,1,4,4,9,Regulars
221,1,3,3,7,Regulars
5331,5,3,5,13,Loyal
1911,5,5,5,15,Champions
20,1,2,2,5,At Risk
8786,3,4,3,10,Loyal
10582,5,4,4,13,Champions
1915,3,4,5,12,Loyal
8897,5,5,4,14,Champions
2371,4,2,2,8,New Customers
4303,2,1,2,5,At Risk
6825,1,1,1,3,At Risk
1072,2,2,2,6,At Risk
4964,1,4,4,9,Regulars
2461,2,1,1,4,At Risk
10736,4,4,5,13,Champions
3194,1,4,5,10,Loyal
10839,3,1,1,5,Regulars
49,4,1,1,6,New Customers
4290,5,1,1,7,New Customers
10219,3,1,1,5,Regulars
4211,5,2,2,9,New Customers
1135,1,3,1,5,At Risk
6299,4,5,4,13,Champions
10846,4,4,4,12,Champions
347,4,3,3,10,Loyal
6543,3,3,5,11,Loyal
10446,3,3,4,10,Loyal
3479,3,1,1,5,Regulars
11075,4,3,3,10,Loyal
4442,2,2,2,6,At Risk
199,4,3,3,10,Loyal
6722,1,5,4,10,Loyal
796,5,5,4,14,Champions
3749,3,5,5,13,Loyal
8523,4,2,2,8,New Customers
310,1,4,3,8,Regulars
8629,2,1,1,4,At Risk
236,2,2,2,6,At Risk
3483,2,5,5,12,Loyal
4599,2,4,3,9,Regulars
7326,1,1,2,4,At Risk
7352,4,3,3,10,Loyal
2350,1,4,4,9,Regulars
9145,3,4,5,12,Loyal
2964,5,1,2,8,New Customers
5585,5,2,1,8,New Customers
9687,5,3,4,12,Loyal
3732,2,5,4,11,Loyal
6303,2,4,5,11,Loyal
11176,5,4,3,12,Champions
2986,1,1,1,3,At Risk
7462,2,4,3,9,Regulars
3900,3,4,4,11,Loyal
7034,4,2,1,7,New Customers
9493,5,4,5,14,Champions
1143,3,2,1,6,Regulars
1,5,4,3,12,Champions
3855,2,2,2,6,At Risk
5536,2,4,5,11,Loyal
5989,3,5,5,13,Loyal
9499,1,3,5,9,Regulars
6768,2,1,1,4,At Risk
2150,1,4,5,10,Loyal
6646,4,1,1,6,New Customers
4887,2,1,2,5,At Risk
8560,1,4,4,9,Regulars
3321,3,4,3,10,Loyal
11003,5,2,1,8,New Customers
10402,1,1,1,3,At Risk
9904,3,5,4,12,Loyal
6141,3,3,3,9,Regulars
5687,1,5,5,11,Loyal
10856,3,1,1,5,Regulars
5121,4,4,4,12,Champions
4186,5,2,2,9,New Customers
368,2,3,3,8,Regulars
3312,5,2,2,9,New Customers
11121,2,2,2,6,At Risk
5332,5,3,4,12,Loyal
5848,3,4,5,12,Loyal
10343,4,4,5,13,Champions
5935,2,5,4,11,Loyal
2895,2,2,3,7,Regulars
10262,1,2,1,4,At Risk
7848,5,3,3,11,Loyal
9477,5,4,3,12,Champions
4856,4,5,5,14,Champions
7186,3,1,1,5,Regulars
5794,5,4,3,12,Champions
1456,4,5,4,13,Champions
4877,5,1,1,7,New Customers
425,2,4,4,10,Loyal
3007,3,1,1,5,Regulars
1031,5,5,4,14,Champions
4297,2,2,1,5,At Risk
807,4,3,3,10,Loyal
9553,1,1,1,3,At Risk
4271,1,3,3,7,Regulars
4120,2,3,3,8,Regulars
2036,4,3,3,10,Loyal
115,5,3,3,11,Loyal
4259,1,1,1,3,At Risk
8687,3,3,3,9,Regulars
2447,2,2,2,6,At Risk
10140,4,3,5,12,Loyal
9353,2,3,4,9,Regulars
3623,3,2,1,6,Regulars
738,4,3,2,9,Regulars
7631,4,5,4,13,Champions
4789,1,4,5,10,Loyal
773,2,5,3,10,Loyal
10602,4,2,2,8,New Customers
1446,5,5,5,15,Champions
3270,1,2,2,5,At Risk
8443,5,2,2,9,New Customers
9653,5,2,2,9,New Customers
8916,2,1,1,4,At Risk
8017,1,2,1,4,At Risk
5830,1,4,5,10,Loyal
4597,2,4,5,11,Loyal
7023,1,3,3,7,Regulars
8086,4,2,1,7,New Customers
8825,3,5,3,11,Loyal
2930,5,4,5,14,Champions
1928,2,2,2,6,At Risk
7108,3,4,3,10,Loyal
10925,1,5,4,10,Loyal
9960,3,1,1,5,Regulars
9224,1,5,4,10,Loyal
5519,5,4,4,13,Champions
5046,1,5,5,11,Loyal
7037,3,3,3,9,Regulars
905,4,2,2,8,New Customers
8624,2,4,4,10,Loyal
8945,3,2,3,8,Regulars
6445,2,3,4,9,Regulars
2727,5,3,3,11,Loyal
6404,5,3,3,11,Loyal
11074,1,4,5,10,Loyal
10150,5,4,5,14,Champions
1968,4,1,1,6,New Customers
6534,1,1,2,4,At Risk
9485,4,2,3,9,New Customers
7053,2,4,5,11,Loyal
4654,3,4,5,12,Loyal
9760,4,5,5,14,Champions
1048,5,2,2,9,New Customers
10619,4,4,5,13,Champions
9308,3,3,4,10,Loyal
10505,1,3,4,8,Regulars
8362,5,4,5,14,Champions
2625,4,3,3,10,Loyal
4637,2,5,5,12,Loyal
9972,4,1,1,6,New Customers
4483,2,4,5,11,Loyal
4487,2,2,2,6,At Risk
4988,3,2,2,7,Regulars
8931,1,5,5,11,Loyal
5871,1,3,3,7,Regulars
2008,1,4,4,9,Regulars
3139,3,4,5,12,Loyal
10037,2,3,4,9,Regulars
10673,5,4,5,14,Champions
5303,3,4,4,11,Loyal
538,2,2,2,6,At Risk
7922,4,5,4,13,Champions
5692,1,1,1,3,At Risk
4843,1,4,4,9,Regulars
6383,2,2,1,5,At Risk
1628,3,3,4,10,Loyal
1204,3,5,5,13,Loyal
3673,3,5,4,12,Loyal
760,5,5,4,14,Champions
8957,3,4,4,11,Loyal
4128,3,4,4,11,Loyal
6810,2,3,5,10,Loyal
5386,2,4,5,11,Loyal
8700,1,2,2,5,At Risk
3202,2,4,5,11,Loyal
1328,3,4,4,11,Loyal
8405,1,3,3,7,Regulars
6515,1,1,1,3,At Risk
2882,4,3,4,11,Loyal
7574,1,1,1,3,At Risk
6387,4,2,2,8,New Customers
5320,4,3,2,9,Regulars
5048,3,2,2,7,Regulars
8146,1,1,1,3,At Risk
10031,3,3,1,7,Regulars
5748,1,3,3,7,Regulars
2134,1,4,4,9,Regulars
1523,4,2,2,8,New Customers
9665,3,3,3,9,Regulars
4640,2,5,4,11,Loyal
3635,2,4,3,9,Regulars
3547,5,2,2,9,New Customers
2456,1,3,2,6,At Risk
5633,3,3,3,9,Regulars
7801,1,4,4,9,Regulars
10489,4,5,5,14,Champions
7011,3,2,2,7,Regulars
2620,3,1,1,5,Regulars
3933,3,5,4,12,Loyal
10981,4,4,5,13,Champions
1734,4,2,2,8,New Customers
10995,5,2,2,9,New Customers
6357,4,4,3,11,Loyal
9209,1,5,5,11,Loyal
10286,5,5,4,14,Champions
2611,2,4,5,11,Loyal
1600,2,4,3,9,Regulars
3308,3,2,2,7,Regulars
5407,2,5,4,11,Loyal
2166,3,1,1,5,Regulars
3955,4,1,1,6,New Customers
6634,2,1,1,4,At Risk
3056,2,5,4,11,Loyal
5718,5,5,5,15,Champions
6872,3,3,3,9,Regulars
8164,5,4,5,14,Champions
4580,3,5,5,13,Loyal
9305,2,5,5,12,Loyal
453,5,2,1,8,New Customers
8545,5,3,5,13,Loyal
9850,4,1,1,6,New Customers
7378,4,4,3,11,Loyal
7646,2,5,4,11,Loyal
1640,3,2,2,7,Regulars
5184,2,1,1,4,At Risk
8492,4,5,5,14,Champions
11188,1,2,2,5,At Risk
1212,5,5,4,14,Champions
9097,4,3,3,10,Loyal
10473,4,4,3,11,Loyal
7962,5,3,5,13,Loyal
9984,4,4,4,12,Champions
5527,4,2,2,8,New Customers
6374,3,3,3,9,Regulars
7453,3,4,3,10,Loyal
8952,1,5,4,10,Loyal
241,3,4,5,12,Loyal
8975,3,2,2,7,Regulars
6119,3,1,1,5,Regulars
5236,4,4,5,13,Champions
5723,2,2,2,6,At Risk
1710,3,4,3,10,Loyal
1970,5,2,2,9,New Customers
5313,4,2,1,7,New Customers
10634,3,3,3,9,Regulars
7010,3,4,5,12,Loyal
8562,2,2,3,7,Regulars
3158,5,1,1,7,New Customers
4436,4,2,2,8,New Customers
5287,2,2,2,6,At Risk
2445,1,1,2,4,At Risk
6059,1,5,5,11,Loyal
4550,3,1,2,6,Regulars
4240,2,2,2,6,At Risk
8911,5,4,4,13,Champions
3706,3,2,2,7,Regulars
3628,1,2,2,5,At Risk
10175,5,1,1,7,New Customers
8985,3,5,5,13,Loyal
5204,4,4,5,13,Champions
9220,3,4,5,12,Loyal
9888,5,3,4,12,Loyal
5263,1,1,1,3,At Risk
1020,2,4,5,11,Loyal
9503,2,3,3,8,Regulars
10613,3,2,2,7,Regulars
67,5,2,2,9,New Customers
6019,5,1,2,8,New Customers
5863,1,4,4,9,Regulars
3717,2,4,4,10,Loyal
6730,1,2,1,4,At Risk
10749,2,3,2,7,Regulars
4998,1,3,4,8,Regulars
6287,5,1,1,7,New Customers
5985,5,2,2,9,New Customers
4754,1,2,2,5,At Risk
4002,5,5,4,14,Champions
8870,2,4,3,9,Regulars
966,1,5,4,10,Loyal
4767,3,4,5,12,Loyal
9725,5,1,1,7,New Customers
4475,1,5,5,11,Loyal
5740,5,2,2,9,New Customers
5731,2,1,1,4,At Risk
7290,2,4,4,10,Loyal
3846,1,3,3,7,Regulars
8104,4,3,3,10,Loyal
4507,1,4,5,10,Loyal
11013,1,3,4,8,Regulars
4491,5,5,5,15,Champions
3759,4,5,4,13,Champions
1162,4,4,4,12,Champions
2055,4,1,1,6,New Customers
10766,4,3,3,10,Loyal
4415,5,2,1,8,New Customers
3005,5,5,5,15,Champions
2223,3,5,5,13,Loyal
4817,1,1,1,3,At Risk
2875,1,5,4,10,Loyal
10536,2,2,1,5,At Risk
11112,4,5,5,14,Champions
3807,1,5,4,10,Loyal
9197,1,2,1,4,At Risk
10832,5,3,3,11,Loyal
6421,4,4,5,13,Champions
4207,4,5,5,14,Champions
577,5,1,1,7,New Customers
10855,5,3,3,11,Loyal
3081,2,1,1,4,At Risk
3535,2,3,4,9,Regulars
247,5,4,3,12,Champions
8707,5,3,5,13,Loyal
9523,1,1,1,3,At Risk
6072,5,4,5,14,Champions
6295,3,5,4,12,Loyal
10914,5,1,1,7,New Customers
1509,1,4,3,8,Regulars
5577,2,1,1,4,At Risk
7348,5,3,5,13,Loyal
1127,2,4,5,11,Loyal
1833,1,2,2,5,At Risk
4944,4,3,4,11,Loyal
9080,5,2,2,9,New Customers
6466,4,2,2,8,New Customers
9964,3,3,3,9,Regulars
4790,3,3,4,10,Loyal
10245,2,3,4,9,Regulars
1109,4,1,1,6,New Customers
6001,2,5,4,11,Loyal
5538,2,3,5,10,Loyal
10552,5,3,3,11,Loyal
1545,1,4,3,8,Regulars
7409,2,3,3,8,Regulars
4444,4,1,2,7,New Customers
146,2,4,5,11,Loyal
6271,5,1,2,8,New Customers
10065,4,2,2,8,New Customers
4741,5,4,3,12,Champions
246,2,4,3,9,Regulars
375,2,3,4,9,Regulars
1524,5,3,4,12,Loyal
10022,2,1,1,4,At Risk
7451,4,4,5,13,Champions
11010,2,2,1,5,At Risk
4356,2,3,5,10,Loyal
3885,5,1,2,8,New Customers
1175,4,3,3,10,Loyal
880,3,1,2,6,Regulars
2320,1,5,4,10,Loyal
850,5,4,4,13,Champions
4713,5,2,2,9,New Customers
675,2,3,3,8,Regulars
5025,4,2,2,8,New Customers
2308,3,3,3,9,Regulars
5995,3,4,3,10,Loyal
6749,2,4,5,11,Loyal
1010,1,2,2,5,At Risk
8977,3,1,1,5,Regulars
4756,3,5,5,13,Loyal
3412,2,3,4,9,Regulars
606,1,1,1,3,At Risk
5961,4,1,2,7,New Customers
2975,1,5,5,11,Loyal
2894,2,4,5,11,Loyal
7613,1,3,3,7,Regulars
10542,2,2,2,6,At Risk
8015,1,4,5,10,Loyal
10617,4,2,1,7,New Customers
11166,1,3,3,7,Regulars
849,2,4,4,10,Loyal
523,3,2,2,7,Regulars
4066,2,2,1,5,At Risk
8414,2,2,2,6,At Risk
819,1,5,4,10,Loyal
4961,3,2,2,7,Regulars
749,4,2,2,8,New Customers
5430,5,5,4,14,Champions
7755,1,3,3,7,Regulars
10525,3,1,1,5,Regulars
8310,1,5,5,11,Loyal
10710,2,1,1,4,At Risk
5031,5,5,5,15,Champions
2613,5,3,3,11,Loyal
213,1,2,1,4,At Risk
967,5,5,3,13,Champions
1077,3,3,4,10,Loyal
7959,5,2,5,12,New Customers
640,2,5,4,11,Loyal
4252,2,3,3,8,Regulars
8432,5,5,4,14,Champions
6218,2,3,3,8,Regulars
6905,3,4,4,11,Loyal
5922,3,3,3,9,Regulars
3598,3,4,3,10,Loyal
6116,5,1,2,8,New Customers
6263,4,2,2,8,New Customers
10486,3,3,4,10,Loyal
2410,2,3,4,9,Regulars
193,1,1,1,3,At Risk
3363,1,1,1,3,At Risk
8278,5,3,5,13,Loyal
10660,2,3,3,8,Regulars
8686,2,2,2,6,At Risk
1604,1,3,3,7,Regulars
5907,4,1,1,6,New Customers
10669,5,3,3,11,Loyal
2918,2,2,2,6,At Risk
5735,4,4,5,13,Champions
359,4,4,3,11,Loyal
8387,2,2,3,7,Regulars
1829,3,4,5,12,Loyal
3839,2,3,2,7,Regulars
9392,5,1,1,7,New Customers
2292,1,1,1,3,At Risk
10466,1,2,2,5,At Risk
9855,4,5,4,13,Champions
4088,4,2,2,8,New Customers
5231,5,1,1,7,New Customers
590,4,3,5,12,Loyal
8732,1,5,5,11,Loyal
2315,3,1,2,6,Regulars
3515,1,2,2,5,At Risk
2245,3,2,2,7,Regulars
6283,2,4,4,10,Loyal
2246,1,2,2,5,At Risk
6606,5,4,5,14,Champions
5545,2,3,4,9,Regulars
7342,5,5,4,14,Champions
837,5,3,2,10,Loyal
9500,2,4,4,10,Loyal
3602,3,2,3,8,Regulars
234,2,1,1,4,At Risk
2995,2,3,4,9,Regulars
1118,1,4,4,9,Regulars
7789,1,5,5,11,Loyal
3068,5,1,1,7,New Customers
8955,3,1,1,5,Regulars
945,3,2,2,7,Regulars
5644,1,3,3,7,Regulars
7192,3,4,3,10,Loyal
2324,5,5,4,14,Champions
697,2,4,5,11,Loyal
3439,2,3,3,8,Regulars
1506,4,2,2,8,New Customers
232,5,3,3,11,Loyal
8876,3,3,2,8,Regulars
4500,3,5,5,13,Loyal
9739,3,2,2,7,Regulars
10395,4,2,2,8,New Customers
1176,3,1,1,5,Regulars
1627,1,4,4,9,Regulars
938,4,2,2,8,New Customers
2740,1,2,2,5,At Risk
257,2,4,5,11,Loyal
4058,2,4,4,10,Loyal
7736,4,2,2,8,New Customers
8210,2,4,3,9,Regulars
833,2,2,2,6,At Risk
6230,3,3,2,8,Regulars
7325,1,1,1,3,At Risk
1307,5,2,2,9,New Customers
1502,2,2,1,5,At Risk
6211,3,1,1,5,Regulars
843,3,5,4,12,Loyal
4174,1,2,2,5,At Risk
9757,1,5,5,11,Loyal
6918,3,1,1,5,Regulars
286,3,3,2,8,Regulars
11086,5,1,1,7,New Customers
1921,2,2,2,6,At Risk
4138,2,5,4,11,Loyal
7718,4,2,4,10,New Customers
1291,1,3,3,7,Regulars
6862,2,3,1,6,At Risk
4136,2,2,2,6,At Risk
803,1,1,1,3,At Risk
4298,2,1,1,4,At Risk
10833,3,5,4,12,Loyal
9606,2,3,5,10,Loyal
8534,3,5,4,12,Loyal
5153,1,5,5,11,Loyal
961,1,3,4,8,Regulars
5011,3,5,4,12,Loyal
6653,2,4,3,9,Regulars
9094,4,3,3,10,Loyal
810,3,4,4,11,Loyal
5493,4,1,1,6,New Customers
2147,1,5,5,11,Loyal
5107,4,1,1,6,New Customers
3979,1,3,5,9,Regulars
6049,1,5,5,11,Loyal
8147,3,2,1,6,Regulars
1857,5,2,2,9,New Customers
3910,2,3,5,10,Loyal
5207,3,5,4,12,Loyal
11114,1,2,2,5,At Risk
5429,5,2,2,9,New Customers
9400,2,4,5,11,Loyal
7488,4,5,4,13,Champions
195,4,3,3,10,Loyal
635,3,5,3,11,Loyal
7527,1,2,2,5,At Risk
10319,3,4,5,12,Loyal
2296,5,1,1,7,New Customers
10637,2,2,2,6,At Risk
2931,1,4,5,10,Loyal
907,4,4,3,11,Loyal
3698,5,4,5,14,Champions
9516,1,5,5,11,Loyal
679,3,1,1,5,Regulars
7384,5,3,3,11,Loyal
5043,1,3,3,7,Regulars
5267,3,1,1,5,Regulars
339,1,4,3,8,Regulars
2516,1,2,2,5,At Risk
9010,1,5,5,11,Loyal
378,2,4,4,10,Loyal
4808,5,1,1,7,New Customers
5068,2,1,1,4,At Risk
7628,5,2,2,9,New Customers
7128,1,1,1,3,At Risk
2811,4,2,2,8,New Customers
3551,4,2,3,9,New Customers
1663,1,1,1,3,At Risk
5543,3,5,4,12,Loyal
1577,5,3,5,13,Loyal
10641,5,2,2,9,New Customers
5336,4,1,2,7,New Customers
6024,2,4,5,11,Loyal
1878,1,1,1,3,At Risk
3099,3,3,3,9,Regulars
6055,1,4,5,10,Loyal
5841,2,5,4,11,Loyal
3972,2,4,3,9,Regulars
4394,3,5,5,13,Loyal
5758,4,5,5,14,Champions
6658,4,5,5,14,Champions
4603,3,4,4,11,Loyal
8427,2,5,5,12,Loyal
10260,2,3,3,8,Regulars
7143,5,5,4,14,Champions
8789,2,3,3,8,Regulars
6197,4,2,2,8,New Customers
4554,1,3,3,7,Regulars
4937,2,1,1,4,At Risk
1920,3,2,2,7,Regulars
8749,2,1,2,5,At Risk
1650,5,5,5,15,Champions
10377,4,3,3,10,Loyal
9206,4,5,4,13,Champions
10971,4,3,3,10,Loyal
6398,5,2,1,8,New Customers
9212,5,5,5,15,Champions
7937,1,2,2,5,At Risk
839,3,2,2,7,Regulars
4246,5,1,3,9,New Customers
158,5,3,5,13,Loyal
4832,1,2,2,5,At Risk
5621,5,3,3,11,Loyal
1945,5,4,5,14,Champions
5147,3,5,5,13,Loyal
2535,4,4,4,12,Champions
11039,3,3,3,9,Regulars
9495,4,3,4,11,Loyal
9635,5,2,2,9,New Customers
2173,4,1,1,6,New Customers
942,4,3,3,10,Loyal
9386,1,3,3,7,Regulars
5510,5,3,3,11,Loyal
873,5,5,5,15,Champions
2253,5,1,2,8,New Customers
5181,3,1,1,5,Regulars
979,5,2,2,9,New Customers
10390,4,1,1,6,New Customers
4698,4,3,3,10,Loyal
7793,5,5,4,14,Champions
1745,1,4,5,10,Loyal
10590,1,5,5,11,Loyal
5080,5,3,5,13,Loyal
8369,4,1,1,6,New Customers
5232,4,2,3,9,New Customers
2407,5,4,5,14,Champions
3834,4,5,4,13,Champions
7912,2,2,2,6,At Risk
7712,2,4,4,10,Loyal
1065,1,4,5,10,Loyal
7275,4,2,2,8,New Customers
1343,3,4,3,10,Loyal
1384,5,2,2,9,New Customers
9967,4,5,3,12,Champions
6181,4,5,4,13,Champions
10507,5,3,4,12,Loyal
2674,2,3,4,9,Regulars
2698,3,3,3,9,Regulars
3231,1,1,1,3,At Risk
4096,4,3,2,9,Regulars
10476,5,2,3,10,New Customers
5948,1,3,3,7,Regulars
9140,1,2,2,5,At Risk
10258,1,1,1,3,At Risk
5675,1,5,3,9,Regulars
4743,2,5,4,11,Loyal
8805,5,3,3,11,Loyal
1542,4,4,3,11,Loyal
6770,5,2,2,9,New Customers
8773,4,3,3,10,Loyal
10475,4,3,3,10,Loyal
10420,3,2,3,8,Regulars
7514,2,3,2,7,Regulars
2902,1,1,1,3,At Risk
4345,3,1,1,5,Regulars
793,4,1,1,6,New Customers
10909,5,4,5,14,Champions
3769,5,1,1,7,New Customers
8702,5,1,1,7,New Customers
4791,4,1,1,6,New Customers
2963,3,4,5,12,Loyal
8216,5,3,3,11,Loyal
8140,3,2,2,7,Regulars
10146,5,1,1,7,New Customers
5289,4,1,2,7,New Customers
2587,4,2,1,7,New Customers
4405,5,5,4,14,Champions
8663,1,1,1,3,At Risk
2589,2,2,2,6,At Risk
3421,2,5,4,11,Loyal
10490,5,3,3,11,Loyal
4094,1,3,3,7,Regulars
9958,3,4,4,11,Loyal
2534,5,2,2,9,New Customers
4188,3,3,3,9,Regulars
6613,4,5,4,13,Champions
10827,3,2,2,7,Regulars
5491,2,3,3,8,Regulars
8402,3,5,4,12,Loyal
8783,3,4,3,10,Loyal
10010,3,2,2,7,Regulars
618,5,5,4,14,Champions
9121,3,3,5,11,Loyal
361,1,1,1,3,At Risk
2678,2,2,3,7,Regulars
6376,1,4,3,8,Regulars
524,3,1,2,6,Regulars
10341,3,2,3,8,Regulars
5654,4,2,2,8,New Customers
4098,5,2,1,8,New Customers
5824,5,1,1,7,New Customers
7000,5,5,4,14,Champions
2561,3,5,5,13,Loyal
5229,1,1,1,3,At Risk
4086,2,1,2,5,At Risk
2428,4,2,2,8,New Customers
8254,3,1,1,5,Regulars
2836,2,1,1,4,At Risk
8418,2,2,2,6,At Risk
1362,2,3,3,8,Regulars
7152,2,1,1,4,At Risk
10033,3,1,1,5,Regulars
9349,1,5,4,10,Loyal
274,2,2,1,5,At Risk
3388,5,3,3,11,Loyal
922,2,1,1,4,At Risk
8588,1,3,3,7,Regulars
2518,5,1,1,7,New Customers
574,1,2,2,5,At Risk
3220,4,2,2,8,New Customers
5967,2,2,2,6,At Risk
1183,5,1,1,7,New Customers
6856,2,2,2,6,At Risk
4530,4,5,5,14,Champions
1553,2,5,5,12,Loyal
4682,1,3,3,7,Regulars
8204,1,4,5,10,Loyal
5221,1,5,4,10,Loyal
1232,3,3,5,11,Loyal
1927,3,3,4,10,Loyal
5788,3,3,3,9,Regulars
6652,4,3,4,11,Loyal
6246,3,5,5,13,Loyal
5975,1,1,2,4,At Risk
6875,4,3,3,10,Loyal
4399,5,3,4,12,Loyal
4042,1,2,2,5,At Risk
2157,3,2,2,7,Regulars
10133,5,5,5,15,Champions
2525,2,4,3,9,Regulars
8233,5,4,3,12,Champions
9483,4,5,4,13,Champions
2945,4,1,1,6,New Customers
10403,3,2,1,6,Regulars
5074,5,1,1,7,New Customers
10524,4,4,4,12,Champions
4690,3,4,3,10,Loyal
7521,3,4,5,12,Loyal
7196,4,1,1,6,New Customers
4406,4,5,5,14,Champions
9672,1,2,2,5,At Risk
4864,2,3,2,7,Regulars
4706,2,1,1,4,At Risk
4070,1,4,4,9,Regulars
25,5,4,4,13,Champions
3697,4,2,2,8,New Customers
217,2,5,5,12,Loyal
4220,4,2,2,8,New Customers
5286,2,2,3,7,Regulars
9559,2,5,4,11,Loyal
2849,4,5,4,13,Champions
7787,1,5,4,10,Loyal
3102,4,1,1,6,New Customers
5868,3,1,1,5,Regulars
8370,3,4,4,11,Loyal
9988,1,5,4,10,Loyal
2939,1,3,5,9,Regulars
5529,3,5,3,11,Loyal
9743,1,5,5,11,Loyal
5763,2,4,3,9,Regulars
3478,5,5,4,14,Champions
7494,5,3,3,11,Loyal
1763,2,5,5,12,Loyal
7250,3,5,3,11,Loyal
2005,1,2,2,5,At Risk
10770,2,5,4,11,Loyal
6885,4,1,2,7,New Customers
2072,4,4,4,12,Champions
9463,5,5,5,15,Champions
6318,3,5,5,13,Loyal
4093,2,4,3,9,Regulars
5751,3,1,1,5,Regulars
3340,3,4,3,10,Loyal
3594,2,5,4,11,Loyal
3584,4,5,5,14,Champions
3643,2,3,4,9,Regulars
851,3,5,4,12,Loyal
7706,1,5,4,10,Loyal
3967,5,5,4,14,Champions
10128,4,5,4,13,Champions
486,4,4,5,13,Champions
9,1,2,2,5,At Risk
9451,1,5,5,11,Loyal
9264,5,5,5,15,Champions
3865,5,2,2,9,New Customers
2853,2,3,3,8,Regulars
1490,1,5,4,10,Loyal
6310,5,2,2,9,New Customers
10380,3,2,2,7,Regulars
3887,5,2,2,9,New Customers
4278,2,4,5,11,Loyal
8643,4,5,5,14,Champions
1998,1,2,2,5,At Risk
10795,5,2,1,8,New Customers
11110,3,1,1,5,Regulars
2408,4,5,4,13,Champions
202,3,3,5,11,Loyal
7998,2,2,2,6,At Risk
830,5,3,5,13,Loyal
3536,2,2,2,6,At Risk
6050,4,5,5,14,Champions
125,2,3,3,8,Regulars
3463,3,5,4,12,Loyal
2804,1,2,2,5,At Risk
3745,1,2,2,5,At Risk
9771,1,3,3,7,Regulars
451,1,1,1,3,At Risk
10530,5,3,4,12,Loyal
1079,3,4,4,11,Loyal
8920,5,5,4,14,Champions
6678,5,2,2,9,New Customers
3852,3,5,4,12,Loyal
528,1,4,5,10,Loyal
73,1,1,1,3,At Risk
5589,1,5,4,10,Loyal
10212,3,2,2,7,Regulars
6365,5,1,2,8,New Customers
5636,3,2,2,7,Regulars
591,2,4,4,10,Loyal
2217,3,1,1,5,Regulars
2544,2,2,2,6,At Risk
7725,4,3,4,11,Loyal
8091,3,3,4,10,Loyal
7321,1,3,4,8,Regulars
5462,2,5,5,12,Loyal
7791,1,1,1,3,At Risk
955,1,3,3,7,Regulars
4037,2,1,1,4,At Risk
6642,3,2,2,7,Regulars
2793,5,5,4,14,Champions
5424,4,2,2,8,New Customers
879,2,4,3,9,Regulars
9530,5,1,1,7,New Customers
4828,5,4,4,13,Champions
10699,4,2,2,8,New Customers
1497,5,3,3,11,Loyal
7476,1,5,5,11,Loyal
4390,5,5,4,14,Champions
10478,3,5,4,12,Loyal
1081,4,5,4,13,Champions
4261,4,5,5,14,Champions
9916,1,2,1,4,At Risk
5350,4,4,5,13,Champions
8135,3,1,1,5,Regulars
8685,3,4,3,10,Loyal
4967,5,3,3,11,Loyal
2130,5,2,2,9,New Customers
9298,1,4,5,10,Loyal
8175,2,2,2,6,At Risk
6257,1,3,3,7,Regulars
3790,4,1,1,6,New Customers
9952,3,3,4,10,Loyal
3503,2,3,4,9,Regulars
5223,1,2,2,5,At Risk
4608,5,5,4,14,Champions
1626,4,1,1,6,New Customers
4764,3,3,2,8,Regulars
2471,4,3,3,10,Loyal
5892,5,3,3,11,Loyal
2612,4,5,5,14,Champions
4971,4,2,2,8,New Customers
5185,1,3,4,8,Regulars
10069,3,1,2,6,Regulars
2262,2,3,3,8,Regulars
1131,3,2,2,7,Regulars
1041,5,4,3,12,Champions
24,1,3,1,5,At Risk
3409,2,3,3,8,Regulars
7022,5,4,5,14,Champions
7943,3,1,1,5,Regulars
5272,2,4,3,9,Regulars
5453,4,5,5,14,Champions
2565,2,4,5,11,Loyal
800,3,1,1,5,Regulars
11092,2,2,1,5,At Risk
5062,2,1,1,4,At Risk
8969,3,5,4,12,Loyal
4656,4,5,4,13,Champions
4480,2,4,3,9,Regulars
9971,4,3,3,10,Loyal
6729,1,4,5,10,Loyal
1773,4,1,2,7,New Customers
9242,5,4,5,14,Champions
1764,1,3,3,7,Regulars
6215,4,1,1,6,New Customers
10099,4,5,4,13,Champions
5423,4,1,1,6,New Customers
940,5,3,3,11,Loyal
3011,4,2,3,9,New Customers
3298,1,5,4,10,Loyal
8286,3,2,2,7,Regulars
9668,5,2,2,9,New Customers
5120,2,4,5,11,Loyal
6097,2,5,3,10,Loyal
7019,3,3,3,9,Regulars
7408,5,3,3,11,Loyal
8041,4,4,4,12,Champions
252,5,3,3,11,Loyal
9986,5,2,1,8,New Customers
3276,3,2,2,7,Regulars
3859,4,5,4,13,Champions
3570,2,3,3,8,Regulars
3783,3,2,2,7,Regulars
10207,3,1,1,5,Regulars
10906,3,3,3,9,Regulars
3427,5,5,4,14,Champions
5209,4,4,4,12,Champions
10711,4,5,4,13,Champions
10785,5,2,1,8,New Customers
2814,5,1,1,7,New Customers
6866,3,1,1,5,Regulars
1665,2,4,5,11,Loyal
6575,3,5,3,11,Loyal
3829,1,1,1,3,At Risk
3091,4,4,4,12,Champions
10141,5,1,1,7,New Customers
5177,3,3,3,9,Regulars
7005,2,4,4,10,Loyal
6409,5,4,5,14,Champions
7485,3,2,2,7,Regulars
8079,1,2,2,5,At Risk
8395,3,5,5,13,Loyal
10352,5,2,2,9,New Customers
4931,5,3,4,12,Loyal
13,3,1,1,5,Regulars
1834,2,1,2,5,At Risk
2285,5,3,3,11,Loyal
2295,3,5,4,12,Loyal
1378,4,5,4,13,Champions
2781,3,3,5,11,Loyal
1165,2,5,3,10,Loyal
1404,1,3,3,7,Regulars
6457,2,5,4,11,Loyal
2639,3,2,2,7,Regulars
8299,3,1,2,6,Regulars
6437,1,1,2,4,At Risk
6912,2,5,4,11,Loyal
7327,2,2,1,5,At Risk
5299,3,5,5,13,Loyal
4127,1,5,5,11,Loyal
8143,3,3,3,9,Regulars
1964,2,4,5,11,Loyal
3690,4,5,5,14,Champions
3433,3,4,4,11,Loyal
3389,2,5,5,12,Loyal
4712,5,2,2,9,New Customers
1170,3,3,3,9,Regulars
6347,4,1,1,6,New Customers
4065,5,3,3,11,Loyal
8230,4,1,2,7,New Customers
1215,3,5,5,13,Loyal
5939,1,2,2,5,At Risk
2156,4,2,1,7,New Customers
7788,3,1,1,5,Regulars
10323,1,3,3,7,Regulars
7947,1,1,1,3,At Risk
1891,5,3,5,13,Loyal
2570,4,5,4,13,Champions
9256,5,5,4,14,Champions
295,2,5,4,11,Loyal
7397,3,4,4,11,Loyal
6349,2,4,5,11,Loyal
10790,3,1,1,5,Regulars
10398,1,1,1,3,At Risk
2431,2,1,2,5,At Risk
550,1,4,4,9,Regulars
1890,1,1,1,3,At Risk
10742,2,2,4,8,Regulars
10356,5,1,1,7,New Customers
4676,1,5,5,11,Loyal
8852,1,5,4,10,Loyal
3565,2,2,2,6,At Risk
5294,3,2,2,7,Regulars
1958,1,5,4,10,Loyal
7349,5,2,2,9,New Customers
8799,5,2,2,9,New Customers
1351,4,5,5,14,Champions
1045,3,3,3,9,Regulars
7732,1,4,4,9,Regulars
8070,1,3,3,7,Regulars
477,4,5,5,14,Champions
7832,4,5,5,14,Champions
2202,1,1,2,4,At Risk
7396,1,5,5,11,Loyal
4055,3,2,2,7,Regulars
10340,2,4,3,9,Regulars
10091,2,3,4,9,Regulars
7629,3,2,1,6,Regulars
10640,2,3,3,8,Regulars
3498,5,5,4,14,Champions
6742,1,1,1,3,At Risk
1172,2,5,5,12,Loyal
569,4,4,5,13,Champions
4686,4,5,5,14,Champions
1381,4,4,3,11,Loyal
2634,5,2,2,9,New Customers
10905,5,3,3,11,Loyal
1744,2,1,1,4,At Risk
1000,3,5,4,12,Loyal
3828,2,5,5,12,Loyal
8605,4,2,2,8,New Customers
10304,2,1,2,5,At Risk
4351,1,1,2,4,At Risk
10129,4,4,5,13,Champions
2499,4,4,3,11,Loyal
10092,3,5,5,13,Loyal
7500,4,4,3,11,Loyal
5796,2,5,4,11,Loyal
10556,3,4,3,10,Loyal
1064,5,1,1,7,New Customers
48,1,2,2,5,At Risk
7610,4,4,3,11,Loyal
263,5,2,2,9,New Customers
10814,5,5,5,15,Champions
9710,1,5,4,10,Loyal
9292,2,5,5,12,Loyal
10250,3,1,1,5,Regulars
7881,4,5,4,13,Champions
5847,1,5,4,10,Loyal
737,3,3,5,11,Loyal
3571,3,4,4,11,Loyal
7807,4,3,3,10,Loyal
3878,5,1,1,7,New Customers
5092,4,4,3,11,Loyal
2154,4,2,1,7,New Customers
5394,3,2,1,6,Regulars
3798,1,2,2,5,At Risk
3524,5,2,2,9,New Customers
5247,3,2,1,6,Regulars
5883,2,4,4,10,Loyal
2118,2,4,4,10,Loyal
8812,3,2,1,6,Regulars
6616,3,3,3,9,Regulars
2797,4,5,4,13,Champions
4328,1,2,2,5,At Risk
9167,2,5,4,11,Loyal
10560,4,1,1,6,New Customers
2631,4,4,4,12,Champions
8312,1,1,1,3,At Risk
5534,4,2,3,9,New Customers
5093,5,2,2,9,New Customers
7592,1,2,3,6,At Risk
8895,2,4,4,10,Loyal
8584,3,4,5,12,Loyal
2694,3,1,1,5,Regulars
8910,5,3,3,11,Loyal
7433,1,3,2,6,At Risk
164,3,3,3,9,Regulars
10477,5,2,2,9,New Customers
2681,5,4,3,12,Champions
5150,2,2,1,5,At Risk
5283,2,2,2,6,At Risk
9645,1,5,5,11,Loyal
10678,1,5,4,10,Loyal
7261,5,4,3,12,Champions
9648,4,3,3,10,Loyal
2870,5,4,3,12,Champions
8008,3,2,2,7,Regulars
1513,2,5,5,12,Loyal
6173,3,5,4,12,Loyal
1419,5,2,2,9,New Customers
9150,4,2,2,8,New Customers
7960,1,5,5,11,Loyal
1250,1,2,2,5,At Risk
9905,2,3,3,8,Regulars
10691,3,1,1,5,Regulars
7002,5,3,3,11,Loyal
2952,1,2,2,5,At Risk
8439,1,3,4,8,Regulars
762,4,4,4,12,Champions
2831,1,5,5,11,Loyal
6977,1,5,5,11,Loyal
6289,1,2,2,5,At Risk
4168,4,5,3,12,Champions
8397,1,1,1,3,At Risk
9284,4,5,4,13,Champions
6237,1,3,3,7,Regulars
3130,1,2,1,4,At Risk
1619,5,4,5,14,Champions
1990,2,4,5,11,Loyal
5513,3,1,1,5,Regulars
269,2,4,4,10,Loyal
8093,2,3,4,9,Regulars
10513,2,3,5,10,Loyal
10177,5,4,5,14,Champions
2549,1,1,1,3,At Risk
5782,5,5,4,14,Champions
10057,2,5,5,12,Loyal
10307,1,4,3,8,Regulars
8566,5,1,1,7,New Customers
2415,1,3,4,8,Regulars
5684,4,2,2,8,New Customers
8334,4,2,2,8,New Customers
9166,3,5,4,12,Loyal
1440,1,5,4,10,Loyal
78,3,1,1,5,Regulars
5441,1,3,3,7,Regulars
5302,5,3,5,13,Loyal
4687,1,5,5,11,Loyal
1087,4,2,2,8,New Customers
6859,4,2,2,8,New Customers
9860,5,3,3,11,Loyal
7129,2,5,4,11,Loyal
5866,4,3,3,10,Loyal
10521,5,3,2,10,Loyal
7393,5,2,2,9,New Customers
7849,5,5,4,14,Champions
332,3,3,3,9,Regulars
9847,4,3,3,10,Loyal
531,3,5,5,13,Loyal
9576,2,2,2,6,At Risk
6906,2,4,4,10,Loyal
7419,1,2,1,4,At Risk
3170,1,3,4,8,Regulars
8527,4,4,3,11,Loyal
7872,5,5,3,13,Champions
9931,4,3,1,8,Regulars
10595,5,1,2,8,New Customers
4609,5,4,3,12,Champions
5010,2,1,1,4,At Risk
4427,3,5,5,13,Loyal
11148,1,1,1,3,At Risk
1168,2,4,5,11,Loyal
9595,5,3,5,13,Loyal
10163,4,4,5,13,Champions
2886,2,5,5,12,Loyal
6710,1,2,2,5,At Risk
5316,1,2,2,5,At Risk
9029,2,5,5,12,Loyal
521,3,4,3,10,Loyal
1459,5,3,4,12,Loyal
10241,5,1,1,7,New Customers
1630,3,3,3,9,Regulars
3254,2,3,4,9,Regulars
9064,5,4,5,14,Champions
3678,5,5,4,14,Champions
4227,2,2,2,6,At Risk
9467,3,1,1,5,Regulars
8486,4,4,3,11,Loyal
2186,4,5,5,14,Champions
3286,2,2,1,5,At Risk
8602,1,5,4,10,Loyal
3722,1,2,1,4,At Risk
6715,5,5,4,14,Champions
4796,2,1,1,4,At Risk
9612,5,1,1,7,New Customers
3766,5,4,4,13,Champions
1399,3,4,5,12,Loyal
1570,5,5,4,14,Champions
3426,1,5,5,11,Loyal
3074,2,4,5,11,Loyal
8341,4,1,1,6,New Customers
5180,3,2,2,7,Regulars
6461,2,5,4,11,Loyal
7679,3,1,1,5,Regulars
10702,2,4,3,9,Regulars
7505,4,1,1,6,New Customers
5113,2,3,5,10,Loyal
10858,4,5,4,13,Champions
2961,1,3,3,7,Regulars
2747,1,4,5,10,Loyal
3010,1,4,5,10,Loyal
5790,2,2,2,6,At Risk
6892,4,5,4,13,Champions
1743,1,2,4,7,Regulars
3578,4,3,3,10,Loyal
8462,3,1,2,6,Regulars
5558,1,3,5,9,Regulars
4619,5,3,3,11,Loyal
8780,2,4,3,9,Regulars
10789,5,2,2,9,New Customers
10779,5,1,1,7,New Customers
5896,1,3,3,7,Regulars
2337,2,2,1,5,At Risk
10951,4,3,3,10,Loyal
544,3,3,4,10,Loyal
17,1,5,4,10,Loyal
10680,2,2,2,6,At Risk
3265,4,1,1,6,New Customers
5623,1,1,1,3,At Risk
5832,4,4,5,13,Champions
5544,4,5,5,14,Champions
6417,1,5,5,11,Loyal
5831,1,4,5,10,Loyal
7101,4,5,5,14,Champions
10176,3,5,3,11,Loyal
2326,5,1,2,8,New Customers
4385,1,2,1,4,At Risk
2929,4,2,2,8,New Customers
10686,2,1,1,4,At Risk
2546,5,1,2,8,New Customers
3283,3,5,4,12,Loyal
3138,1,5,5,11,Loyal
7966,3,5,5,13,Loyal
3112,5,1,1,7,New Customers
10872,2,4,5,11,Loyal
2181,3,3,5,11,Loyal
1867,3,4,5,12,Loyal
1518,4,5,4,13,Champions
5734,1,2,2,5,At Risk
2878,1,3,3,7,Regulars
1458,3,2,1,6,Regulars
7007,3,2,2,7,Regulars
6200,3,5,4,12,Loyal
1403,3,1,1,5,Regulars
4827,5,4,3,12,Champions
6250,2,5,4,11,Loyal
9291,4,1,1,6,New Customers
2478,3,1,1,5,Regulars
1139,3,4,5,12,Loyal
5138,2,1,1,4,At Risk
5393,2,1,1,4,At Risk
10413,2,5,4,11,Loyal
5015,1,2,2,5,At Risk
10868,1,4,5,10,Loyal
10676,5,4,4,13,Champions
2495,4,5,4,13,Champions
7842,3,2,2,7,Regulars
9955,4,2,2,8,New Customers
2162,5,4,3,12,Champions
3434,2,4,5,11,Loyal
7919,5,5,5,15,Champions
5626,5,3,3,11,Loyal
6428,4,4,4,12,Champions
8514,3,1,1,5,Regulars
10448,3,4,3,10,Loyal
2109,2,5,5,12,Loyal
7530,3,2,2,7,Regulars
8925,4,5,4,13,Champions
3009,5,3,5,13,Loyal
6355,5,2,1,8,New Customers
3517,4,2,2,8,New Customers
1158,4,2,2,8,New Customers
6203,3,5,5,13,Loyal
7165,3,5,4,12,Loyal
3595,4,5,4,13,Champions
8537,2,4,5,11,Loyal
4331,3,4,5,12,Loyal
6281,4,3,4,11,Loyal
4338,4,1,1,6,New Customers
2452,5,4,3,12,Champions
9507,5,3,3,11,Loyal
8360,2,3,3,8,Regulars
10311,5,3,3,11,Loyal
5117,4,4,3,11,Loyal
4867,5,2,2,9,New Customers
9289,5,1,2,8,New Customers
10913,3,1,1,5,Regulars
3032,1,2,3,6,At Risk
8524,5,2,2,9,New Customers
3334,4,4,5,13,Champions
4470,5,2,2,9,New Customers
1406,3,5,3,11,Loyal
8619,5,1,1,7,New Customers
10821,3,3,3,9,Regulars
4552,4,3,3,10,Loyal
898,4,2,2,8,New Customers
9797,4,3,3,10,Loyal
10949,5,4,5,14,Champions
8212,1,2,2,5,At Risk
6248,3,5,5,13,Loyal
10164,2,3,5,10,Loyal
4547,1,1,1,3,At Risk
6815,5,4,4,13,Champions
4122,2,3,4,9,Regulars
10841,3,4,3,10,Loyal
5370,4,4,3,11,Loyal
176,2,3,3,8,Regulars
4860,2,1,1,4,At Risk
10757,4,1,1,6,New Customers
4023,4,2,2,8,New Customers
6679,4,1,1,6,New Customers
9923,5,2,2,9,New Customers
7181,1,2,1,4,At Risk
3599,2,5,5,12,Loyal
405,2,4,3,9,Regulars
6870,2,3,3,8,Regulars
832,1,5,4,10,Loyal
2002,1,4,5,10,Loyal
3657,5,2,2,9,New Customers
500,2,5,5,12,Loyal
1951,1,5,4,10,Loyal
3262,4,5,5,14,Champions
4102,3,1,1,5,Regulars
7042,5,1,2,8,New Customers
10598,1,2,1,4,At Risk
255,4,1,1,6,New Customers
2375,2,1,1,4,At Risk
9829,3,2,2,7,Regulars
6214,3,1,2,6,Regulars
4954,3,4,3,10,Loyal
7861,4,4,5,13,Champions
4837,3,5,5,13,Loyal
9423,3,2,1,6,Regulars
4198,5,1,1,7,New Customers
153,4,1,1,6,New Customers
9323,5,5,4,14,Champions
10001,1,2,2,5,At Risk
3945,1,5,4,10,Loyal
3799,5,5,4,14,Champions
8625,2,2,1,5,At Risk
3491,4,5,5,14,Champions
983,1,3,3,7,Regulars
9119,4,3,3,10,Loyal
4786,1,5,4,10,Loyal
5872,4,5,4,13,Champions
6568,1,1,2,4,At Risk
5628,4,5,5,14,Champions
5631,1,4,4,9,Regulars
4974,1,5,5,11,Loyal
8416,5,2,1,8,New Customers
5454,1,1,1,3,At Risk
4095,1,4,3,8,Regulars
5474,2,3,3,8,Regulars
4268,3,2,2,7,Regulars
10701,2,5,5,12,Loyal
3507,3,3,5,11,Loyal
2079,5,5,5,15,Champions
626,4,1,1,6,New Customers
4426,4,4,3,11,Loyal
2591,3,3,4,10,Loyal
10509,3,2,2,7,Regulars
6382,1,1,1,3,At Risk
6673,3,2,2,7,Regulars
7441,1,5,5,11,Loyal
1071,5,5,4,14,Champions
10061,4,5,4,13,Champions
7187,3,5,4,12,Loyal
8775,2,2,2,6,At Risk
1612,1,2,1,4,At Risk
2345,3,4,5,12,Loyal
322,1,2,1,4,At Risk
10897,2,5,5,12,Loyal
123,1,3,4,8,Regulars
6103,3,2,2,7,Regulars
7899,2,4,5,11,Loyal
10500,1,2,2,5,At Risk
1655,1,1,1,3,At Risk
2406,2,4,3,9,Regulars
2712,1,4,4,9,Regulars
5517,3,1,1,5,Regulars
10643,4,4,4,12,Champions
2254,1,4,5,10,Loyal
10281,5,4,3,12,Champions
6958,3,1,1,5,Regulars
954,2,2,2,6,At Risk
5079,1,2,2,5,At Risk
10339,1,3,3,7,Regulars
4643,3,2,2,7,Regulars
3117,1,3,3,7,Regulars
6497,4,4,3,11,Loyal
5396,3,5,5,13,Loyal
1052,4,5,4,13,Champions
2802,2,4,4,10,Loyal
6343,5,5,5,15,Champions
6507,5,2,2,9,New Customers
7901,4,1,1,6,New Customers
4865,5,4,3,12,Champions
2686,3,1,1,5,Regulars
3107,4,3,3,10,Loyal
7734,3,5,5,13,Loyal
1146,5,5,4,14,Champions
11031,1,1,1,3,At Risk
7428,3,4,5,12,Loyal
975,4,3,3,10,Loyal
1103,2,4,5,11,Loyal
3422,2,2,5,9,Regulars
1055,3,1,1,5,Regulars
6544,2,5,4,11,Loyal
1241,5,1,1,7,New Customers
2909,1,4,5,10,Loyal
5802,3,2,2,7,Regulars
1407,5,2,2,9,New Customers
6183,5,2,2,9,New Customers
340,5,4,3,12,Champions
5991,4,3,3,10,Loyal
3104,1,4,5,10,Loyal
9729,3,5,4,12,Loyal
1008,4,5,4,13,Champions
11091,2,1,1,4,At Risk
3969,3,2,2,7,Regulars
1916,1,4,3,8,Regulars
9907,1,5,4,10,Loyal
87,5,2,2,9,New Customers
8659,3,5,4,12,Loyal
6262,1,5,5,11,Loyal
6147,3,1,1,5,Regulars
8832,4,2,2,8,New Customers
10067,2,1,1,4,At Risk
7532,4,2,2,8,New Customers
4915,1,5,4,10,Loyal
2115,2,2,2,6,At Risk
2088,1,5,5,11,Loyal
2493,4,4,3,11,Loyal
6292,2,4,5,11,Loyal
1631,5,5,5,15,Champions
10104,2,1,1,4,At Risk
3006,1,1,1,3,At Risk
3919,2,4,5,11,Loyal
11181,1,1,1,3,At Risk
642,2,2,2,6,At Risk
4369,3,4,5,12,Loyal
10127,4,3,3,10,Loyal
271,4,3,3,10,Loyal
4973,4,1,1,6,New Customers
2948,2,2,2,6,At Risk
2715,5,3,2,10,Loyal
10432,4,1,1,6,New Customers
9216,4,2,1,7,New Customers
7124,2,3,2,7,Regulars
9727,5,2,2,9,New Customers
5136,3,5,4,12,Loyal
9790,5,4,5,14,Champions
1818,4,1,1,6,New Customers
1100,4,3,2,9,Regulars
7873,4,3,3,10,Loyal
10609,5,2,2,9,New Customers
6950,4,2,1,7,New Customers
7233,5,3,5,13,Loyal
9481,1,3,2,6,At Risk
7699,4,3,3,10,Loyal
2711,5,1,1,7,New Customers
8933,5,2,2,9,New Customers
8726,3,3,2,8,Regulars
1515,5,1,1,7,New Customers
5186,3,5,4,12,Loyal
10157,2,3,3,8,Regulars
5667,1,5,5,11,Loyal
902,2,3,3,8,Regulars
977,5,4,3,12,Champions
7313,2,5,5,12,Loyal
7600,5,1,1,7,New Customers
9706,1,2,2,5,At Risk
2429,5,4,5,14,Champions
3520,1,3,4,8,Regulars
10394,1,4,5,10,Loyal
4548,2,1,1,4,At Risk
9362,5,4,3,12,Champions
3968,2,5,5,12,Loyal
4084,3,5,4,12,Loyal
6721,4,4,5,13,Champions
2829,4,5,4,13,Champions
1772,5,4,5,14,Champions
1544,3,4,5,12,Loyal
492,5,4,3,12,Champions
4377,4,3,3,10,Loyal
4541,1,3,3,7,Regulars
1321,3,2,2,7,Regulars
8858,2,4,3,9,Regulars
3266,1,2,2,5,At Risk
11187,4,2,2,8,New Customers
8207,5,1,1,7,New Customers
9723,5,5,4,14,Champions
2666,4,5,4,13,Champions
5721,2,5,5,12,Loyal
10652,3,4,5,12,Loyal
1646,4,2,1,7,New Customers
4418,4,5,5,14,Champions
2656,2,1,2,5,At Risk
7990,5,1,1,7,New Customers
8722,4,5,5,14,Champions
7118,2,5,5,12,Loyal
2980,3,2,1,6,Regulars
1839,4,2,2,8,New Customers
10722,2,4,3,9,Regulars
2632,5,4,3,12,Champions
9014,2,2,2,6,At Risk
7620,2,2,2,6,At Risk
10968,5,5,4,14,Champions
11133,5,4,3,12,Champions
2736,1,5,4,10,Loyal
1876,5,1,2,8,New Customers
5959,1,3,3,7,Regulars
1092,5,4,4,13,Champions
4333,2,2,1,5,At Risk
3850,3,1,1,5,Regulars
6168,4,1,1,6,New Customers
607,4,5,3,12,Champions
10469,3,4,5,12,Loyal
6983,4,2,1,7,New Customers
3661,3,4,5,12,Loyal
9303,5,1,1,7,New Customers
692,1,1,1,3,At Risk
736,2,2,1,5,At Risk
9589,3,4,5,12,Loyal
4838,3,1,1,5,Regulars
9246,2,4,3,9,Regulars
6261,1,4,3,8,Regulars
7366,5,4,5,14,Champions
10659,5,3,1,9,Regulars
1448,4,2,1,7,New Customers
4286,4,5,4,13,Champions
4749,3,5,3,11,Loyal
4478,1,5,4,10,Loyal
4201,4,4,3,11,Loyal
8720,3,1,4,8,Regulars
10084,5,2,1,8,New Customers
7004,1,2,2,5,At Risk
9817,2,5,4,11,Loyal
8080,3,1,1,5,Regulars
9432,4,3,2,9,Regulars
8372,1,1,1,3,At Risk
10870,3,4,5,12,Loyal
4001,3,5,3,11,Loyal
7270,1,4,5,10,Loyal
8235,5,5,4,14,Champions
9405,3,3,2,8,Regulars
